 , , , , , , , , , , , , , , 
 , , , , ,0, , ,0, , ,0, , , 
 , , , , , , , , , , , , , , 
 , ,0, , , , , ,1, , ,1, , , 
 , , , , , , , , , , , , , , 
 , ,1, , , , , , , , ,2, , , 
 , , , , ,1, , ,2, , , , , , 
 , , , , , , , , , , ,3, , , 
 , ,2, , ,2, , , , , , , , , 
 , , , , , , , , , , , , , , 
 , ,3, ,a,3, ,b,3, , , , , , 
 , , , , , , , , , , , , , , 
 , , , , , , , , , , , , , , 
 , , , , , , , , , , , , , , 
 , , , , , , , , , , , , , , 