 , , , , , , , , , , , , , , 
 ,z,0, , ,0, , ,0, , ,0, ,z, 
 ,z, , , ,1, , ,2, , , , ,z, 
 ,z,2, , , , , , , , ,1, ,z, 
 ,z,3, , ,3, , ,3, , ,3, ,z, 
 , , , , , , , , , , , , , , 
 , , , , , , , , , , , , , , 
 , , , , , , , , , , , , , , 
 ,z,0, , , , , , , , ,0, ,z, 
 ,z,1, , , , , , , , ,1, ,z, 
 ,z,3, , , , , , , , ,3, ,z, 
 , , , , , , , , , , , , , , 
 , , , ,b, , ,a, , , , , , , 
 , , , , , , , , , , , , , , 
 , , , , , , , , , , , , , , 