 , , , , , , , , , , , , , , 
 ,0,1,2,0,1,2,0,1,2,0,1,2,0, 
 ,3,1,2,3,4,5,0,4,5,0,1,2,3, 
 ,3,1,2,3,1,2,3, , ,3,1,2,3, 
 ,3,1,2,0,4,5,3,1,2,3,1,2,3, 
 , , , ,3,7,8,3,4,5,0, , , , 
 ,9,a,a,3,4,5,3,1,2,3,a,a,c, 
 , , , ,3, , , , , ,6, , , , 
 ,0,1,2,3, , , , , ,3,1,2,0, 
 ,3,4,5,3,a,a,b,a,a,3,1,2,3, 
 ,3,4,5,3, , , , , ,3,4,5,3, 
 , , , ,3,1,2,0,1,2,3, , , , 
 , , , ,3,4,5,3,4,5,3, , , , 
 ,9,a,a,c, , , , , ,9,a,a,c, 
 , , , , , , , , , , , , , , 