 , , , , , , , , , , , , , , 
 ,0,1,2,0,1,2,0,1,2,0,1,2,0, 
 ,3,4,5,3,4,5,3,7,8,6,7,8,6, 
 ,3,4,5,3,7,8,3,4,5,3,4,5,3, 
 ,6,7,8,3,4,5,3,7,8,3,4,5,3, 
 ,3,4,5,3,4,5,3,4,5,3,4,5,3, 
 , , , , ,7,8,3,4,5,0, , , , 
 , , , ,0,4,5,3,7,8, , , , , 
 , , , , ,7,8,3,4,5,0, , , , 
 , , , ,0,4,5,3,4,5,0, , , , 
 ,9,a,a,c, , ,6, , ,9,a,a,c, 
 , , , , , , ,3, , , , , , , 
 , , , , , , , , , , , , , , 
 , , , ,9,a,a,b,a,a,c, , , , 
 , , , , , , , , , , , , , , 