 , , , , , , , , , , , , , , 
 ,z,0, , ,0, , ,0, , ,0, ,z, 
 ,z,2, , ,1, , , , , , , , , 
 ,z,1, , , , , , , , ,2, ,z, 
 , , , , ,2, , , , , ,1, ,z, 
 ,z,3, , , , , , , , ,3, ,z, 
 , , , , , , , ,1, , , , , , 
 , , , ,z, , , , , , , , , , 
 , , , , , , , ,2, , , , , , 
 , , , ,b,3, , ,3, ,z, , , , 
 , , , , , , , , , , , , , , 
 , , , , , , ,a, , , , , , , 
 , , , , , , , , , , , , , , 
 , , , , , , , , , , , , , , 
 , , , , , , , , , , , , , , 