 , , , , , , , , , , , , , , 
 , ,0, , ,0, , ,0, , ,0, , , 
 , ,2, , ,1, , , , , , , , , 
 , ,1, , , , , , , , ,2, , , 
 , , , , ,2, , , , , ,1, , , 
 , ,3, , , , , , , , ,3, , , 
 , , , , , , , ,1, , , , , , 
 , , , , , , , , , , , , , , 
 , , , , , , , ,2, , , , , , 
 , , , ,b,3, , ,3, , , , , , 
 , , , , , , , , , , , , , , 
 , , , , , , ,a, , , , , , , 
 , , , , , , , , , , , , , , 
 , , , , , , , , , , , , , , 
 , , , , , , , , , , , , , , 