 , , , , , , , , , , , , , , 
 ,0,1,2,0,1,2,0,1,2,0,1,2,0, 
 ,3, , ,3,4,5,3, , ,3, , ,3, 
 ,6,1,2,6,4,5,6,1,2,6,1,2,6, 
 , ,4,5,6,7,8,6,4,5,3, , ,3, 
 ,0,7,8,6, , ,3,4,5,6,1,2,6, 
 ,3,4,5,6,1,2,6,7,8,6,4,5, , 
 ,3,4,5,3, , ,3, , ,6,7,8,0, 
 ,6,7,8,6,1,2,6,1,2,6,4,5,3, 
 ,3, , ,3, , ,3, , ,3,4,5,3, 
 ,6,1,2,6,1,2,6,1,2,6,7,8,6, 
 , , , , , , , , , , , , , , 
 , , , , , , , , , , , , , , 
 ,9,a,a,b,a,a,b,a,a,b,a,a,c, 
 , , , , , , , , , , , , , , 