 , , , , , , , , , , , , , , 
 ,0,1,2,0,1,2,0,1,2,0,1,2,0, 
 ,6, , ,6,7,8,6, , ,6, , ,6, 
 ,3,1,2,3,7,8,3,1,2,3,1,2,3, 
 , ,7,8,3,4,5,3,7,8,6, , ,6, 
 ,0,4,5,3, , ,6,7,8,3,1,2,3, 
 ,6,7,8,3,1,2,3,4,5,3,7,8, , 
 ,6,7,8,6, , ,6, , ,3,4,5,0, 
 ,3,4,5,3,1,2,3,1,2,3,7,8,6, 
 ,6, , ,6, , ,6, , ,6,7,8,6, 
 ,3,1,2,3,1,2,3,1,2,3,4,5,3, 
 , , , , , , , , , , , , , , 
 , , , , , , , , , , , , , , 
 ,9,a,a,b,a,a,b,a,a,b,a,a,c, 
 , , , , , , , , , , , , , , 