 , , , , , , , , , , , , , , 
 ,z, , , ,0, , ,0, , ,0, ,z, 
 , , , , , , , , , , , , , , 
 ,z,0, , , , , ,1, , ,1, ,z, 
 , , , , , , , , , , , , , , 
 ,z,1, , , , , , , , ,2, ,z, 
 , , , , ,1, , ,2, , , , , , 
 , , , , , , , , , , ,3, ,z, 
 ,z,2, , ,2, , , , , , , , , 
 , , , , , , , , , , , , , , 
 ,z,3, ,a,3, ,b,3, , , , ,z, 
 , , , , , , , , , , , , , , 
 , , , , , , , , , , , , , , 
 , , , , , , , , , , , , , , 
 , , , , , , , , , , , , , , 